1111111111111
10010000000C1
1000011111001
1P0E110000001
100C01001C001
1010000000001
1000010000101
1000100111001
1111111111111